NO texture/wall_n.xpm 
SO texture/wall_s.xpm
WE texture/wall_w.xpm 
EA texture/wall_e.xpm
F 255,0,0
      C 0,30,250

111111111111111111111
100000000000000000001
100000000000000000001
100000000000000000001
100000000000000000001
1000000000E0000000001
100000000000000000001
100000000000000000001
100000000000000000001
100000000000000000001
111111111111111111111






