NO texture/bricks.xpm 
SO texture/glass.xpm
WE texture/grass.xpm 
EA texture/lavaf4.xpm
F 255,0,0
      C 0,30,250

11111111111111111111
10000000000000000001
10000000000000000001
10000000000000000001
10000000000000000001
1000000000E000000001
10000000000000000001
10000000000000000001
10000000000000000001
10000000000000000001
11111111111111111111