NO texture/wall_n.xpm 
SO texture/wall_s.xpm
WE texture/wall_w.xpm 
EA texture/wall_e.xpm
F 220,100,0
C 225,30,0

 111111111111111111111
10000000000000000000001
 10011111111111111110001
  1001             1001
   100111111111111110011111111111
    10000000000000000000000000001
     100111111111111001111111111
    100111111111111100111111111111
   10W0000000000000000000000000001
  100111111100111111111110000000001
 1001      1001         1000000001
11111       111          11111111