
NO texture/wall_n.xpm 
SO texture/wall_s.xpm
WE texture/wall_w.xpm 
EA texture/wall_e.xpm

F 220,100,0
C 225,30,0

1111        111
10001       101
10S001111111101
1000000000000001
111111111111111