NO texture/grass.xpm
SO texture/bricks.xpm 
WE texture/glass.xpm 
EA texture/lavaf4.xpm 
F 220,100,0
C 225,30,0

111111111111       1111111111111               111111111111111111                                     
100000100001       1000001000001               111000000000000011                          
100000100001       1000001000001                  111000000000001                    
11111000000011111110000001000001                     1100000000001                      
11111111100000000000000000011111                       1000000000011                  
    100000000000110000000001                      11111110000000000011111                                         
    10000000000000000000000111111111111111111111110000000000000000000011                        
    1000000000S00000000000000000000000000000000000000000000010000000011                            
 11110000000000000000000000111111111111111111111110000000000000000000011                             
10000000000000001100000000000001               111000000000000000000001111         
 1111110000000000000000111000001               1110000000110011000000011          
     110000001001000000111000001               1110000000110011000000011         
     100000010000100000000000001               1110000001000000100000011           
     11000010000001000001000001                  10000110000000010000011                                
     11111111111111111111111111                  11111111111111111111111                               