NO texture/Light-Jade-Textured-Faux-Metallic-Concrete-Wallpaper-R6579.xpm 
SO texture/Shop-a-unique-art-inspired-wallpaper-or-wall-murals-for-the-home.xpm 
WE texture/Soft-Green-Plain-Textured-Wallpaper-R8208.xpm 
EA texture/Toile-de-fond-abstrait-vert-Grunge-Texture-Studio-DHP-420.xpm 
F 53,94,59
C 229,244,254

 111111111111111111111
100000000000000000000011
 1001111111001111111100011
  1001    1001     1110001
   10011111101111110011101111111
    10000000000000000000000000001
     100111111111111001111110011
    100110000001111100111111001111
   10W0000000000000000000000000001
  100111111100111111111110000000001
 1001      1001         1000000001
11111       111          11111111

 
                           
                                                 